TTTTTTTTTTTTT
T    TTTTTTTT
TTTTTT      T
TTTTTT      T
T    T      T
TTTTTTTTTTTTT