TTTTTTTTTTTTTTTTTTTTTTTTT
T                 T     T
T   T     TTT     T     T
T   T     T       T     T
T   T     T       T     T
T         TTT     T     T
T                       T
T         TTTTTTTT      T
T         TTTTT         T
TTTTTTTTTTTTTTTTTTTTTTTTT